50 50 50 50 50 50 50 50 50 50 50 50 50 50 50 50 50 50 50 50
50 0 0 0 50 0 0 0 0 30 1 1 1 50 50 0 0 0 0 50
50 0 0 0 50 0 0 0 0 30 1 1 1 50 50 0 30 0 0 50
50 0 0 0 50 0 0 0 0 30 1 1 1 50 50 0 0 0 0 50
0 0 30 0 50 0 0 0 0 50 1 1 1 50 50 0 0 0 0 0
0 0 0 0 50 0 0 0 0 50 1 1 1 50 50 0 0 0 0 0
0 0 0 0 50 0 0 0 0 50 1 1 1 50 50 0 0 0 0 0
0 0 0 0 50 0 0 0 0 50 1 1 1 50 50 0 0 0 0 0
50 0 0 0 50 0 0 0 0 50 1 1 1 50 50 0 0 0 0 50
50 0 0 0 50 0 0 0 0 50 1 1 1 50 50 0 0 0 0 50
50 0 0 0 50 0 0 0 0 50 1 1 1 50 50 0 0 0 0 50
50 0 0 0 30 0 0 0 0 50 1 1 1 0 0 30 0 0 0 50
50 0 0 0 30 0 0 0 0 50 1 1 1 0 0 0 0 0 0 50
50 0 0 0 30 0 0 0 0 50 1 1 1 0 0 0 0 0 0 50
50 50 50 50 50 50 50 50 50 50 50 50 50 50 50 50 50 50 50 50
