50 50 50 50 50 50 50 50 50 50 50 50 50 50 50 50 50 50 50 50
50 0 50 0 0 0 0 0 0 0 0 0 30 0 0 50 0 0 0 0
50 50 50 0 0 0 0 0 0 0 0 0 30 0 0 50 0 0 0 0
50 0 0 0 0 0 0 0 0 0 0 0 30 30 30 50 0 0 0 0
50 0 0 0 50 0 0 0 50 0 0 0 0 0 0 50 50 50 50 50
50 0 0 0 50 0 0 0 50 0 0 0 0 0 0 0 30 0 0 50
50 0 0 0 50 0 0 0 50 0 0 0 0 0 0 0 30 0 0 50
50 0 0 0 50 0 0 0 50 50 50 50 50 0 0 0 30 0 0 50
50 0 0 0 50 0 0 0 50 0 0 0 50 0 0 0 30 0 0 50
50 0 0 0 50 0 0 0 50 0 0 0 50 0 0 0 0 50 50 50
50 0 0 0 50 0 0 0 0 0 0 0 50 0 0 0 0 50 0 0
50 0 0 0 50 0 0 0 0 0 0 0 50 0 0 0 0 50 0 0
50 0 0 0 50 0 0 0 0 0 0 0 50 0 0 0 0 50 0 0
50 0 0 0 50 0 0 0 50 0 0 0 50 0 0 0 0 50 0 0
50 0 0 0 50 30 30 30 50 0 0 0 50 0 0 0 0 50 50 50
