50 50 50 50 50 50 0 1 0 1 0 50 50 50 50 50 50 50 50 50
50 0 1 0 1 0 1 0 1 0 1 0 1 0 1 0 1 0 1 50
50 1 0 1 0 1 0 1 0 1 0 1 0 1 0 1 0 1 0 50
50 0 1 0 1 0 1 0 1 0 1 0 1 0 1 0 1 0 1 50
0 1 0 1 0 1 0 1 0 1 0 1 0 1 0 1 0 1 0 50
1 0 1 0 1 0 1 0 1 0 1 0 1 0 1 0 1 0 1 50
0 1 0 1 0 1 0 1 0 1 0 1 0 1 0 1 0 1 0 50
1 0 1 0 1 0 1 0 1 0 1 0 1 0 1 0 1 0 1 50
50 1 0 1 0 1 0 1 0 1 0 1 0 1 0 1 0 1 0 50
50 0 1 0 1 0 1 0 1 0 1 0 1 0 1 0 1 0 1 50
50 1 0 1 0 1 0 1 0 1 0 1 0 1 0 1 0 1 0 50
50 0 1 0 1 0 1 0 1 0 1 0 1 0 1 0 1 0 1 50
50 1 0 1 0 1 0 1 0 1 0 1 0 1 0 1 0 1 0 50
50 0 1 0 1 0 1 0 1 0 1 0 1 0 1 0 1 0 1 50
50 50 50 50 50 50 50 50 50 50 50 50 50 50 50 50 50 50 50 50
