50 50 50 50 50 50 50 50 50 50 50 50 50 50 50 50 50 50 50 50
50 0 0 0 0 0 0 0 0 0 0 0 0 0 0 0 0 0 0 50
50 0 0 0 0 0 0 0 0 0 0 0 0 0 0 0 0 0 0 50
50 0 0 0 0 0 0 0 0 0 0 0 0 0 0 0 0 0 0 50
0 0 0 0 0 0 0 50 50 50 50 50 0 0 0 0 0 0 0 50
0 0 0 0 0 0 0 50 42 42 42 50 0 0 0 0 0 0 0 50
0 0 0 0 0 0 0 50 42 42 42 50 0 0 0 0 0 0 0 50
0 0 0 0 0 0 0 50 42 42 42 50 0 0 0 0 0 0 0 50
50 0 0 0 0 0 0 0 0 0 0 0 0 0 0 0 0 0 0 50
50 0 0 0 0 0 0 0 0 0 0 0 0 0 0 0 0 0 0 50
50 0 0 0 0 0 0 0 0 0 0 0 0 0 0 0 0 0 0 50
50 0 0 0 0 0 0 0 0 0 0 0 0 0 0 0 0 0 0 50
50 0 0 0 0 0 0 0 0 0 0 0 0 0 0 0 0 0 0 50
50 0 0 0 0 0 0 0 0 0 0 0 0 0 0 0 0 0 0 50
50 50 50 50 50 50 50 50 50 50 50 50 50 50 50 50 50 50 50 50
